111111111111111111111111111111
1E00001C000001C0100C010C0001E1
100000000000000010010101110001
101C01101010001C1001010C010101
101101C01110100010010111010101
1P0001111C00C0000000000C0100C1
111111111111111111111111111111