111111111111
101C010CC011
110101101C01
11100P110001
1C0000C000C1
1C000000C101
11C0C0010C01
110100C10001
1C0CC10C1011
1000C00000E1
1C10001C00C1
111111111111