11111111111111111
1000C000C11100101
10011P0CC00011111
1000CC00001010C01
110CC0C001110C011
11010010111000C11
11C0000011100C0C1
111C0000C0CC00101
10CC1C101010100C1
10011100C01C10001
1C00C100C01010C01
10C010001CCCC0001
1C000CC011001C001
111C00C11CC0C01C1
10C1010110C0000C1
110CC0011E10CC011
11111111111111111