111111111111
1P0000000001
10C011110C01
100010000001
101011110101
101000010101
101011110E01
100000000001
111111111111