11111111111111111
1PCCCCCCCCCCCCCC1
1C111C1C111C111C1
1CC1CC1CC1CC101C1
1CC1CC1CC1CC11EC1
1CCCCCCCCCCCCCCC1
11111111111111111